00000000000000000000
00000000000000000000
00000000000000000000
00000000000000000000
00000000000000000000
11111111111111111111
00000000000000000000
00000000000000000000
11111111111111100000