455555555555555555555555555555555555555555555555555555555556
000000000000000000000000000000000000000000000000000000000000
000000000000000000000000000000000000000000000000000000000000
000000000000000000000000000000000000000000000000000000000000
000000000000000000000000000000000000000000000000000000000000
000000000000000000000000000000000000000000000000000000000000
000000000000000000000000000000000000000000000000000000000000
422222222222222222222222222222222222222222222222222222222226
455555555555555555555555555555555555555555555555555555555556
455555555555555555555555555555555555555555555555555555555556