455555555555555555555555555555555555555555555555555555555556455555555555555555555555555555555555555555555555555555555556
000000000000000000000000000000000000000000000000000000000000000000000000000000000000000000000000000000000000000000000000
000000000000000000000000000000000000000000000000000000000000000000000000000000000000000000000000000000000000000000000000
000000000000000000000000000000000000000000000000000000000000000000000000000000000000000000000000000000000000000000000000
000000000000000000000000000000000000000000000000000000000000000000000000000000000000000000000000000000000000000000000000
000000000000000000000000000000000000000000000000000000000000000000000000000000000000000000000000000000000000000000000000
000000000000000000000000000000000000000000000000000000000000000000000000000000000000000000000000000000000000000000000000
222222222200000022222200022222222222222222222222222222222222222222222222222222222222222222222222222222222222222222222222
455555555500000055555500055555555555555555555555555555555556455555555555555555555555555555555555555555555555555555555556
45555555550000005555500055555555555555555555555555555555556455555555555555555555555555555555555555555555555555555555556
455555555500000055555555555555555555555555555555555555555556455555555555555555555555555555555555555555555555555555555556