400000000000000000000000000000000000000000000000000000000006
400000000000000000000000000000000000000000000000000000000006
400000000000000000000000000000000000000000000000000000000006
400000000000000000000000000000000000000000000000000000000006
400000000000000000000000000000000000000000000000000000000006
400000000000000000000000000000000000000000000000000000000006
499999999999999999999999999999999999999999999999999999999996
422222222222222222222222222222222222222222222222222222222226
455555555555555555555555555555555555555555555555555555555556
455555555555555555555555555555555555555555555555555555555556
455555555555555555555555555555555555555555555555555555555556
455555555555555555555555555555555555555555555555555555555556
455555555555555555555555555555555555555555555555555555555556
455555555555555555555555555555555555555555555555555555555556
455555555555555555555555555555555555555555555555555555555556
455555555555555555555555555555555555555555555555555555555556
455555555555555555555555555555555555555555555555555555555556
455555555555555555555555555555555555555555555555555555555556
455555555555555555555555555555555555555555555555555555555556
455555555555555555555555555555555555555555555555555555555556
455555555555555555555555555555555555555555555555555555555556
455555555555555555555555555555555555555555555555555555555556
455555555555555555555555555555555555555555555555555555555556
455555555555555555555555555555555555555555555555555555555556
400000000000000000000000000000000000000000000000000000000006
400000000000000000000000000000000000000000000000000000000006
400000000000000000000000000000000000000000000000000000000006
400000000000000000000000000000000000000000000000000000000006
400000000000000000000000000000000000000000000000000000000006
400000000000000000000000000000000000000000000000000000000006
400000000000000000000000000000000000000000000000000000000006
422222222222222222222222222222222222222222222222222222222226
455555555555555555555555555555555555555555555555555555555556
455555555555555555555555555555555555555555555555555555555556
455555555555555555555555555555555555555555555555555555555556
455555555555555555555555555555555555555555555555555555555556
455555555555555555555555555555555555555555555555555555555556
455555555555555555555555555555555555555555555555555555555556
455555555555555555555555555555555555555555555555555555555556
455555555555555555555555555555555555555555555555555555555556
455555555555555555555555555555555555555555555555555555555556
455555555555555555555555555555555555555555555555555555555556
455555555555555555555555555555555555555555555555555555555556
455555555555555555555555555555555555555555555555555555555556
455555555555555555555555555555555555555555555555555555555556
455555555555555555555555555555555555555555555555555555555556
455555555555555555555555555555555555555555555555555555555556
455555555555555555555555555555555555555555555555555555555556
455555555555555555555555555555555555555555555555555555555556
455555555555555555555555555555555555555555555555555555555556
455555555555555555555555555555555555555555555555555555555556
455555555555555555555555555555555555555555555555555555555556
455555555555555555555555555555555555555555555555555555555556