455555555555555555555555555555555555555555555555555555555556455555555555555555555555555555555555555555555555555555555556
000000000000000000000000000000000000000000000000000000000000000000000000000000000000000000000000000000000000000000000000
000000000000000000000000000000000000000000000000000000000000000000000000000000000000000000000000000000000000000000000000
000000000000000000000000000000000000000000000000000000000000000000000000000000000000000000000000000000000000000000000000
000000000000000000000000000000000000000000000000000000000000000000000000000000000000000000000000000000000000000000000000
000000000000000000000000000000000000000000000000000000000000000000000000000000000000000000000000000000000000000000000000
000000000000000000000000000000000000000000000000000000000000000000000000000000000000000000000000000000000000000000000000
222222222222222222222222222222222222222222222222222222222222222222222222222222222222222222222222222222222222222222222222
455555555555555555555555555555555555555555555555555555555556455555555555555555555555555555555555555555555555555555555556
455555555555555555555555555555555555555555555555555555555556455555555555555555555555555555555555555555555555555555555556
455555555555555555555555555555555555555555555555555555555556455555555555555555555555555555555555555555555555555555555556